Eko (Alias : eko-by-ca)
BNP paribas (Alias : bnp-paribas)
Bpost banque (Alias : bpostbanque)
Beobank (Alias : beobank)
Nobanco (Alias : nobanco)
WeSwap (Alias : weswap)
Veracash (Alias : veracarte)
Sogexia (Alias : sogexia)
EcoPayz (Alias : ecopayz)
BforBank (Alias : bforbank)
ToneoFirst (Alias : toneofirst)
Anytime (Alias : anytime)
Veritas (Alias : veritas)
PCS (Alias : pcs)
N26 (Alias : n26)
Revolut (Alias : revolut)
Paytop (Alias : paytop)
CBlib (Alias : cblib)
CarteZero (Alias : cartezero)
Yunacard (Alias : yunacard)
Travelex (Alias : travelex)
TransCash (Alias : transcash)
Pin Payments (Alias : pin-payments)
QuantumGateway (Alias : quantumgateway)
Paytrace (Alias : paytrace)
Nmi (Alias : nmi)
Cayan (Alias : cayan)
Sproutpos (Alias : sproutpos)
Bluefin (Alias : bluefin)
Verifi (Alias : verifi)
Bluepay (Alias : bluepay)
Ria Money Transfer (Alias : riamoneytransfer)
MoneyGram (Alias : moneygram)
Xoom (Alias : xoom)
Worldremit (Alias : worldremit)
Walmart Money Card (Alias : walmartmoneycard)
TransferWise (Alias : transferwise)
Verse (Alias : verse)
Square (Alias : squareup)
USAePay (Alias : usaepay)
Smile & Pay (Alias : smileandpay)
Visa (Alias : visa)
UnionPay (Alias : unionpay)
MasterCard (Alias : mastercard)
American Express (Alias : american-express)
JCB (Alias : jcb)
Discover (Alias : discover)
Diners Club (Alias : diners-club)
Pulse (Alias : pulse)
UCPB (Alias : ucpb)
PSBank (Alias : psbank)
sumup (Alias : sumup)
payleven (Alias : payleven)
innerfence (Alias : innerfence)
sparkpay (Alias : sparkpay)
izettle (Alias : izettle)
Flint (Alias : flint)
Payline (Alias : payline)
Fortuneo (Alias : fortuneo)
Stripe (Alias : stripe)
LemonWay (Alias : lemonway)
Soon (Alias : soon)
Crédit Agricole (Alias : credit-agricole)
Compte Nickel (Alias : compte-nickel)
CIC (Alias : cic)
Caisse d'épargne (Alias : caisse-d-epargne)
BRED/Banque populaire (Alias : bred-banque-populaire)
Boursorama (Alias : boursorama)
Société Générale (Alias : societe-generale)
Payoneer (Alias : payoneer)
LCL (Alias : lcl)
La Banque Postale (Alias : la-banque-postale)
ING Direct (Alias : ing-direct)
HSBC (Alias : hsbc)
Crédit Mutuel (Alias : credit-mutuel)
Crédit du Nord (Alias : crédit-du-nord)
Banque de France (Alias : banque-de-france)
Neteller (Alias : neteller)
Braintree (Alias : braintree)
Paypal (Alias : paypal)
Amazon pay (Alias : amazon)
authorize.net (Alias : authorize-net)
Barclays (Alias : barclays)
MangoPay (Alias : mangopay)
Payplug (Alias : payplug)
Palatine (Alias : palatine)
Bitcoin (Alias : bitcoin)
Paytoo (Alias : paytoo)
Hipay (Alias : hipay)
Sofort (Alias : sofort)
Monabanq (Alias : monabanq)
Hello banque (Alias : hello-banque)
WebMoney (Alias : webmoney)
Payeer (Alias : payeer)
SolidTrust Pay (Alias : solidtrust-pay)
OkPay (Alias : okpay)
Perfect Money (Alias : perfect-money)
Google Walet (Alias : google-walet)
Western Union (Alias : western-union)
paysafecard (Alias : paysafecard)
Payza (Alias : payza)
Skrill moneybook (Alias : skrill-moneybook)