Maif (Alias : maif)
AssurOnline (Alias : assuronline)
Assurpeople (Alias : assurpeople)
April (Alias : april)
AllSecur (Alias : allsecur)
euro-assurance (Alias : euro-assurance)
SOS Malus (Alias : sos-malus)
Filiassur (Alias : filiassur)
Assurance Maladie (CPAM) (Alias : assurance-maladie-cpam)
AcommeAssure (Alias : acommeassure)
L'olivier Assurance (Alias : l-olivier-assurance)
Macif (Alias : macif)
Aloa Assurances (Alias : aloa-assurances)
Direct assurance (Alias : direct-assurance)
assurbike (Alias : assurbike)
ag2r la mondiale (Alias : ag2r-la-mondiale)
thélem assurances (Alias : thélem-assurances)
smatis (Alias : smatis)
AMPLI Mutuellle (Alias : ampli-mutuellle)
miltis (Alias : miltis)
aviva (Alias : aviva)
Allianz (Alias : allianz)
Amaguiz (Alias : amaguiz)
matmut (Alias : matmut)
RVA (Alias : rva)
eurofil (Alias : eurofil)
AXA (Alias : axa)
AMV (Alias : amv)
Maaf (Alias : maaf)
Alptis (Alias : alptis)
MMA (Alias : mma)
Groupama (Alias : groupama)