
Vikincard (Alias : vikincard)
Maroc Telecom (iam) (Alias : iam)
Telma (Alias : telma)
Paritel (Alias : paritel)
Vialis (Alias : vialis)
Europasat (Alias : europasat)
Nerim (Alias : nerim)
Magic Online (Alias : magic)
Stella Telecom (Alias : stella-telecom)
Ciel telecom (Alias : cieltelecom)	
OVH Telecom (Alias : ovhtelecom)
Coriolis (Alias : coriolis)
Red by SFR (Alias : red-by-sfr)
sosh (Alias : sosh)
Prixtel (Alias : prixtel)
Altice (SFR) (Alias : altice)
PLDTHOME (Alias : pldthome)
Globe (Alias : globe)
Lebara (Alias : lebara)
Lyca Mobile (Alias : lyca-mobile)
Vodafone (Alias : vodafone)
Orange (Alias : orange)
Bouygues Telecom (Alias : bouygues-telecom)
La poste mobile (Alias : la-poste-mobile)
Free (Alias : free)
Ortel Mobile (Alias : ortel-mobile)
NRJ Mobile (Alias : nrj-mobile)
Republika TM (Alias : republika-tm)
Smart (Alias : smart)
Talk 'N Text (Alias : talk-n-text)
Syma (Alias : syma)
Sun Cellular (Alias : sun-cellular)
BeIN Sport (Alias : bein-sport)
MyCanal (Alias : mycanal)
Tooway (Alias : tooway)