
Beebip (Alias : beebip)
Spybot (Alias : spybot)
McAfee (Alias : mcafee)
Notebak (Alias : notebak)
Toolwiz (Alias : toolwiz)
Steganos (Alias : steganos)
Novirusthanks (Alias : novirusthanks)
Pareto (Alias : pareto)
Secureaplus (Alias : secureaplus)
Panda (Alias : panda)
Dr.Web (Alias : dr-web)
ZoneAlarm (Alias : zonealarm)
Comodo (Alias : comodo)
Malwarebytes (Alias : malwarebytes)
immunet (Alias : immunet)
Sophos (Alias : sophos)
Lavasoft (Alias : lavasoft)
voodooshield (Alias : voodooshield)
Norman (Alias : norman)
VIPRE (Alias : vipre)
G-Data (Alias : g-data)
Netgate (Alias : netgate)
TrendMicro (Alias : trendmicro)
Clearsight Antivirus (Alias : clearsight-antivirus)
F-secure (Alias : f-secure)
Avast (Alias : avast)
Twister Antivirus (Alias : twister-antivirus)
AVG (Alias : avg)
ESET (Alias : eset)
Ashampoo Antivirus (Alias : ashampoo-antivirus)
Bullguard (Alias : bullguard)
Kaspersky (Alias : kaspersky)
Norton (Alias : norton)
Crystal Security (Alias : crystal-security)
Bitdefender (Alias : bitdefender)