
HostDime (Alias : hostdime)
IPower (Alias : ipower)
hostgator (Alias : hostgator)
GreenGeeks (Alias : greengeeks)
Lunarpages (Alias : lunarpages)
mochahost (Alias : mochahost)
JustHost (Alias : justhost)
vpslink (Alias : vpslink)
BlueHost (Alias : bluehost)
Cloudflare CDN (Alias : cloudflare-cdn)
Incapsula CDN (Alias : incapsula-cdn)
PlanetHoster (Alias : planethoster)
Webhostingpad (Alias : webhostingpad)
softlayer (Alias : softlayer)
GoDaddy (Alias : godaddy)
iPage (Alias : ipage)
interserver (Alias : interserver)
FatCow (Alias : fatcow)
Likuid (Alias : likuid)
XLHost (Alias : xlhost)
Solution-web (Alias : solution-web)
Webhostinghub (Alias : webhostinghub)
Aabaco (yahoo) (Alias : aabaco)
ArckCloud (Alias : arckcloud)
Liquidweb (Alias : liquidweb)
Hostupon (Alias : hostupon)
Nethosting (Alias : nethosting)
Codero (Alias : codero)
EX2 (Alias : ex2)
Namecheap (Alias : namecheap)
Hostmonster (Alias : hostmonster)
Dreamhost (Alias : dreamhost)
A2hosting (Alias : a2hosting)
Arvixe (Alias : arvixe)
Powweb (Alias : powweb)
Web Hosting Canadia (WHC) (Alias : whc)
Hostrocket (Alias : hostrocket)
Ultra Hosting (Alias : ultra-hosting)
Serverpronto (Alias : serverpronto)
inmotionhosting (Alias : inmotionhosting)
Hostexcellence (Alias : hostexcellence)
hostpapa (Alias : hostpapa)