zaxaa (Alias : zaxaa)
SM SUPERMARKET (Alias : sm-supermarket)
Savemore Market (Alias : savemore-market)
Centro Department store (Alias : centro-department-store)
Easygyro (Alias : easygyro)
Edition Mango (Alias : edition-mango)
Edition Flurus (Alias : edition-flurus)
Edition dupuis (Alias : edition-dupuis)
Massimo Dutti (Alias : massimo-dutti)
ikks (Alias : ikks)
Tout en direct (Alias : tout-en-direct)
Edition Hachette Collection (Alias : edition-hachette-collection)
Glub's (Alias : glubs)
Darty (rachat par fnac) (Alias : fnac-darty)
Hypercacher (Alias : hypercacher)
Tang Frères (Alias : tang-freres)
Paris Store (Alias : paris-store)
Camïeu (Alias : camieu)
Monoprix (Alias : monoprix)
Franprix (Alias : franprix)
Intermarché (Alias : intermarche)
Leader Price (Alias : leader-price)
Casino (Alias : casino)
Carrefour (Alias : carrefour)
Lidl (Alias : lidl)
Metro (Alias : metro)
Auchan (Alias : auchan)
Jwell (Alias : jwell)
Vapostore (Alias : vapostore)
Cool-Vapote (Alias : cool-vapote)
Kiabi (Alias : kiabi)
C&A (Alias : c-a)
Castorama (Alias : castorama)
Conforama (Alias : conforama)
E.Leclerc (Alias : e-leclerc)
Aldi (Alias : aldi)
Power Plate (Alias : power-plate)